6 13 31
###############################
#p * *3       *  ** * *      *#
# # # # #*# # #*# # # # # #*# #
#    * * *6* **  5   *     *  #
# #*# # # # #4# #b#1# # # # #*#
#*     *         **      *  **#
# # #*# # # # # #*#6#*#*# # # #
#   *        *   * *x* *   4  #
# # # # #*# # # # # # #*# #*# #
#   ****         *5           #
# # # # # # # # # #*# # # # #*#
#  ** *2  *    2              #
###############################