2 13 31
###############################
#*  ** # 1  *p    f *   #  b  #
# # # #*# # #*#*# # # #*#*#*# #
#  x*     #**  *  #   * 2 * * #
# # # # # #*# # #*#*# # # # #*#
#b         * **  *  *        d#
# # # # # # # # # #*# #*# # # #
#*  *      *        *        w#
# # # # #*# # # #*#*# # # # # #
#*    *#  *       *           #
# #*# # # # # # #*# # # # # # #
#           1   *  *          #
###############################