1 13 31
###############################
#p     ** *  1 * * *  s 5 *   #
# # # #*# # #*#*# # # #*#*#*# #
#  ##     **2  #  *   # w * * #
# # # # # #*# # #*#*# # # # #*#
#f         x 3*  *  *   #     #
# # # # # # # # # #*# #*# # # #
#*  d      4  *      *        #
# # # # #*# # # #*#*# # # # # #
#*    #*  *       *          b#
# #*# # # # # # #*# # # # # # #
#           *   *  *          #
###############################